2 41 35 0 0 0 0 0 49 0 0 0 52 0 0 56 56 56 56 56 56 56 56 56 56 56 56 56 56 56 56 56 56 56 56 56 56 56 56 56 56 56 56 56 56 56 56 56 56 56 
2 2 41 34 34 34 34 34 35 33 34 35 0 0 0 0 0 0 0 0 48 0 0 0 0 56 56 56 56 56 56 0 0 0 0 0 56 0 56 56 56 56 56 56 56 56 56 56 56 56 
40 43 2 39 40 2 2 2 41 42 2 37 0 0 0 33 34 34 34 35 67 53 0 0 69 0 0 0 0 69 0 33 34 34 35 0 56 56 0 0 53 0 70 56 56 56 56 56 56 56 
38 2 2 37 38 2 2 2 2 2 43 37 0 0 47 38 2 2 2 37 0 0 47 33 35 33 34 34 35 0 47 38 2 2 37 0 48 0 0 0 0 68 0 71 0 53 0 56 56 67 
38 2 2 37 38 2 44 2 39 40 2 37 0 70 0 38 2 43 2 41 34 34 34 42 41 42 2 2 37 0 0 38 2 2 37 33 34 34 34 34 34 35 0 0 0 0 0 56 0 0 
30 31 31 32 38 2 2 2 37 38 2 37 0 52 0 38 2 2 2 2 2 2 2 2 2 2 2 2 37 0 53 38 2 2 41 42 2 2 2 2 2 37 0 48 0 0 68 56 53 0 
56 56 47 53 30 31 31 31 32 38 2 37 0 0 0 30 31 31 31 40 2 2 44 2 2 2 2 2 41 34 34 42 2 2 44 39 31 31 31 40 2 41 34 34 34 35 68 0 0 67 
56 56 0 0 0 53 0 49 53 38 2 37 0 53 0 0 0 49 0 30 31 31 40 2 39 31 31 40 2 2 2 2 2 2 2 37 0 0 0 38 2 2 44 2 2 37 0 0 0 0 
56 56 0 56 0 53 0 0 53 30 31 32 0 0 0 53 0 0 0 53 0 0 30 31 32 0 45 38 2 2 2 43 2 2 2 37 0 0 53 38 2 2 2 2 2 37 70 54 56 69 
56 56 0 56 57 58 0 0 0 0 53 47 53 0 68 69 67 0 0 0 0 0 56 0 69 0 53 38 2 2 2 2 2 2 2 37 0 53 0 38 2 2 2 2 2 41 34 34 34 34 
56 56 56 56 3 58 0 0 0 53 53 53 4 5 6 70 71 53 67 0 56 56 56 0 0 0 0 38 2 44 2 2 2 2 2 41 34 34 34 42 2 2 44 2 2 2 2 2 2 2 
56 56 56 56 56 0 0 0 0 68 0 45 7 3 8 0 0 0 0 56 56 56 58 58 0 0 51 30 31 31 31 31 31 31 40 2 2 2 2 2 2 2 2 2 2 2 44 2 2 2 
56 56 56 56 0 0 0 0 70 71 0 0 7 3 8 0 0 53 0 56 56 56 3 58 0 0 0 49 0 53 0 49 0 66 38 2 2 39 31 40 2 2 2 2 2 2 2 2 2 44 
56 56 56 56 56 0 0 69 67 68 0 53 7 3 8 0 53 0 0 56 0 56 56 56 51 0 67 0 0 0 0 0 0 53 38 2 2 37 0 30 31 31 31 31 31 31 31 40 2 2 
56 56 56 56 56 56 56 0 67 0 53 0 7 64 8 0 0 0 0 0 67 0 56 0 71 33 34 34 34 34 35 0 0 0 38 2 2 37 70 0 0 48 0 0 70 0 0 30 31 40 
56 56 56 56 56 56 53 0 0 0 0 0 7 3 8 0 0 52 0 0 0 0 0 0 0 38 2 2 2 43 37 45 53 33 42 2 2 41 34 35 0 70 0 53 22 23 24 0 69 38 
56 56 54 56 56 56 0 53 0 53 0 52 7 3 8 69 0 53 0 0 0 52 69 71 0 38 44 2 2 2 37 0 0 38 2 2 2 2 2 37 0 0 0 0 25 51 26 33 34 42 
56 56 56 56 56 0 0 0 0 0 0 0 7 3 15 5 5 5 5 5 5 5 6 69 0 38 44 2 43 2 37 53 0 38 2 2 44 2 2 41 34 34 34 35 25 0 26 38 2 2 
56 56 56 56 56 0 53 0 50 0 0 0 7 63 3 3 3 3 3 3 3 3 8 0 0 38 2 2 2 43 37 0 0 30 31 31 40 2 2 2 2 2 39 32 27 28 29 38 2 2 
56 56 56 56 56 54 0 0 0 0 0 69 9 10 10 10 10 10 10 14 3 3 8 0 45 30 31 31 31 31 32 0 0 0 0 47 30 31 40 2 2 2 37 0 68 0 0 38 2 2 
56 56 56 56 56 0 0 0 0 0 0 69 69 0 0 52 0 0 0 9 14 3 8 52 0 0 0 0 53 0 0 0 70 71 70 0 0 0 30 31 40 2 37 0 0 0 69 30 40 44 
56 56 56 56 56 0 0 0 56 67 0 0 0 0 0 0 0 0 0 69 7 63 15 5 6 69 0 0 53 0 0 52 70 69 50 70 70 70 53 45 38 2 41 35 0 53 53 33 42 2 
56 56 56 56 56 0 0 56 56 67 4 5 5 5 5 5 5 5 5 5 17 3 3 3 15 16 16 16 16 16 16 16 6 71 69 50 70 52 71 0 38 2 2 37 0 0 53 38 2 2 
56 56 56 56 54 0 0 56 56 56 7 3 63 3 3 3 3 3 3 3 64 3 3 3 3 3 3 3 65 3 3 3 8 50 70 69 69 70 67 53 38 2 2 37 0 0 0 38 2 2 
56 56 56 56 0 0 56 56 56 56 7 3 12 10 10 10 10 10 10 10 10 10 10 10 10 10 10 10 10 10 10 10 11 67 67 53 67 51 67 0 38 2 2 37 70 0 70 38 2 2 
56 56 56 56 54 0 56 56 0 56 7 3 8 67 0 0 0 52 56 56 56 0 56 45 0 48 53 54 45 48 53 53 0 0 46 0 53 67 67 46 38 2 2 37 0 0 53 38 2 2 
56 56 56 56 0 0 0 0 56 0 56 3 56 0 0 0 53 53 0 56 0 56 0 53 49 53 56 0 53 70 33 34 34 34 34 34 34 34 34 34 42 2 2 37 0 0 48 38 2 2 
56 56 56 0 0 0 0 0 56 56 57 0 58 56 56 0 0 56 0 56 56 71 53 52 71 53 70 46 53 46 38 2 2 2 2 2 2 2 2 2 2 2 2 41 34 34 34 42 2 2 
56 56 56 56 56 54 0 0 0 0 56 58 56 0 0 0 56 53 56 0 56 56 51 0 53 52 33 34 34 34 42 2 2 2 2 2 2 2 44 2 2 2 2 2 2 2 2 2 2 44 
56 56 56 56 56 56 0 50 0 0 7 71 8 56 56 56 0 53 56 56 0 48 56 67 52 47 38 2 2 2 2 2 2 2 2 2 2 2 2 2 2 2 2 2 2 2 2 2 2 2 
56 56 56 56 0 0 0 0 0 0 7 3 15 5 5 5 5 5 5 5 5 5 6 0 0 0 38 2 2 2 2 2 2 44 2 2 2 2 2 2 2 2 2 2 39 31 31 40 2 2 
56 56 56 56 0 0 53 0 0 0 7 3 3 3 3 3 3 3 65 3 3 3 8 53 0 48 30 31 31 31 40 2 2 2 2 2 2 2 44 2 2 2 2 2 37 0 0 38 2 44 
56 56 56 56 54 0 53 53 0 50 9 10 10 10 10 10 10 10 10 10 14 63 8 0 0 0 0 0 71 0 38 2 2 2 2 2 2 2 2 2 2 2 2 2 37 0 0 38 2 2 
56 56 56 56 56 56 0 53 0 0 0 0 0 50 0 0 0 0 0 0 7 3 8 0 0 71 0 0 0 50 38 2 2 2 44 2 2 2 2 2 43 2 39 31 32 0 70 38 2 2 
56 56 56 56 56 56 0 0 0 0 0 0 0 53 0 69 56 56 0 0 7 3 8 53 0 0 71 53 53 48 38 2 2 2 2 2 2 2 2 39 31 31 32 0 22 24 0 30 40 2 
56 56 56 56 56 55 0 0 56 56 66 0 0 0 69 56 56 0 0 0 7 3 8 0 0 0 33 34 35 0 38 2 2 2 2 2 2 2 2 37 70 0 0 0 27 29 33 34 42 2 
56 56 56 56 56 53 53 0 0 56 71 70 0 69 69 4 5 5 5 5 17 3 8 0 0 0 38 43 37 69 38 2 2 2 2 2 2 2 2 41 34 34 34 35 70 0 30 31 40 2 
56 56 56 56 0 0 53 53 0 68 71 71 56 0 56 7 3 3 3 3 65 3 8 0 0 69 38 2 37 53 38 2 2 43 2 2 2 2 2 2 2 2 2 41 34 34 35 0 38 2 
56 56 56 56 56 56 0 53 0 0 66 0 56 56 56 7 3 3 63 3 3 3 8 0 0 0 38 2 37 53 38 2 2 2 2 2 44 2 2 2 2 2 2 2 2 2 37 70 38 2 
56 56 56 56 56 55 0 0 0 0 0 56 56 0 0 7 3 3 12 10 10 10 11 0 53 53 38 2 37 53 38 2 2 2 2 2 2 2 2 2 2 2 2 2 2 2 41 34 42 2 
56 56 56 56 56 56 0 0 0 0 0 0 0 53 0 7 65 3 8 0 0 0 0 0 0 0 38 44 37 0 38 2 2 2 2 2 2 2 2 2 44 2 2 2 2 2 2 2 2 2 
56 56 56 56 56 56 0 0 4 5 5 59 5 5 5 17 3 3 15 5 5 5 5 6 0 0 30 31 32 70 38 2 2 2 2 2 2 2 2 2 2 2 2 2 2 2 44 2 2 2 
56 56 56 56 56 0 0 0 7 12 13 10 59 10 10 10 10 10 10 14 3 3 3 15 5 5 6 56 0 0 38 2 2 2 44 2 2 2 2 2 2 2 39 31 31 31 31 31 31 31 
56 56 56 56 56 56 0 0 7 8 0 56 56 56 0 0 0 0 0 9 10 10 10 10 10 10 11 0 0 56 38 2 2 2 2 2 2 2 2 2 2 2 37 0 0 45 0 56 56 56 
56 56 56 56 56 56 53 0 7 8 0 0 56 0 56 0 56 56 56 0 0 56 56 56 56 0 0 67 69 49 38 2 2 2 2 2 39 31 31 31 31 31 32 0 53 0 54 56 54 56 
56 56 56 56 56 56 56 0 7 8 53 0 67 0 0 56 56 56 56 56 56 0 0 0 56 56 56 56 0 56 38 2 2 2 2 2 37 0 45 0 0 0 67 0 53 0 0 0 0 56 
56 56 56 56 56 56 0 0 7 15 5 5 5 5 5 5 59 59 5 5 5 5 5 5 5 5 6 56 0 0 38 2 2 2 2 2 37 70 0 4 5 5 5 5 5 6 0 70 0 67 
56 56 56 56 56 56 56 0 9 10 10 10 10 10 10 10 59 59 10 10 10 10 10 10 10 14 8 0 56 56 30 31 31 31 31 31 32 0 53 7 3 3 3 3 65 15 5 5 5 5 
56 56 56 56 56 56 56 0 0 0 0 0 0 0 0 0 0 0 0 0 0 0 0 0 67 7 15 5 5 5 5 5 5 5 5 5 5 5 5 17 3 3 3 3 3 3 3 3 3 3 
56 56 56 56 56 56 56 56 56 0 0 0 0 0 56 56 56 56 56 56 56 0 0 0 0 7 3 3 3 3 3 3 3 3 3 3 3 64 3 3 3 3 3 3 3 3 3 3 65 3 
